WWWWWWWWWWWWWW
WGPGGPGGPGGPGW
WHHHGGGGGGGGGW
WHPHHHHHHHGGGW
WHWGGGGGGHGGGW
WSWGGGGGGHHHHE
WWWWWWWWWWWWWW
--------------
00000000000000
00000000000000
02030000000000
00040000050000
00000000000000
01000000060007
00000000000000