WWWWWWWWWWWWWWW
WGPGGPGGPGGPGGW
WHHHGGGGGGGGGGW
WHPHHHHHHHGGGGW
WHWGGGGGGHGGGGW
WSWGGGGGGHHHHHE
WWWWWWWWWWWWWWW
---------------
000000000000000
000000000000000
020300000000000
000400000500000
000000000000000
010000000600007
000000000000000